20
20
100
100
22222222222222222222
21111111112222211112
21122222211111111112
21111111112121221222
22222222112121221112
20000000112111112112
20000002222222212112
20000000000000002112
20202020202020202002
22222222232222222222
20000002232200000002
20000002232200000002
20000000030000000002
20000000030000000002
20222202232202222002
20200002030202000002
20222202030202222002
20000202030200002002
20222202232202222002
22222222222222222222
